Gangnam Style (강남스타일) - PSY
Die Young - Ke$ha
One More Night - Maroon 5
Some Nights - Fun.
I Knew You Were Trouble. - Taylor Swift
We Are Never Ever Getting Back Together - Taylor Swift
Diamonds - Rihanna
Locked Out of Heaven - Bruno Mars
I Cry - Flo Rida
State of Grace - Taylor Swift
Ball (feat. Lil Wayne) - T.I.
Home - Phillip Phillips
Cruise - Florida Georgia Line
As Long As You Love Me (feat. Big Sean) - Justin Bieber
Too Close - Alex Clare
50 Ways to Say Goodbye - Train
Let Me Love You (Until You Learn to Love Yourself) - Ne-Yo
Skyfall - ADELE
Good Time - Owl City and Carly Rae Jepsen
Live While We're Young - One Direction
Catch My Breath - Kelly Clarkson
Ho Hey - The Lumineers
Whistle - Flo Rida
Don't Wake Me Up - Chris Brown
Clique - Kanye West, Jay-Z and Big Sean
Red - Taylor Swift
Blown Away - Carrie Underwood
Everybody Talks - Neon Trees
Titanium (feat. Sia) - David Guetta and Sia
It's Time - Imagine Dragons
Call Me Maybe - Carly Rae Jepsen
Wanted - Hunter Hayes
Beauty and a Beat (feat. Nicki Minaj) - Justin Bieber
The A Team - Ed Sheeran
Finally Found You (feat. Sammy Adams) - Enrique Iglesias
Your Body - Christina Aguilera
Feel Again - OneRepublic
Take a Little Ride - Jason Aldean
Night Train - Jason Aldean
Girl On Fire (Inferno Version) [feat. Nicki Minaj] - Alicia Keys
Blow Me (One Last Kiss) - P!nk
I Won't Give Up - Jason Mraz
Want U Back - Cher Lloyd
Bandz a Make Her Dance (feat. Lil Wayne and 2 Chainz) - Juicy J
I Will Wait - Mumford and Sons
Anything Could Happen - Ellie Goulding
Hard to Love - Lee Brice
Swimming Pools (Drank) - Kendrick Lamar
Wide Awake - Katy Perry
Begin Again - Taylor Swift
Birthday Song (feat. Kanye West) - 2 Chainz
Kiss Tomorrow Goodbye - Luke Bryan
Hall of Fame (feat. will.i.am) - The Script
Lights - Ellie Goulding
Mercy (feat. Big Sean, Pusha T, 2 Chainz) - Kanye West
The Only Way I Know (with Luke Bryan and Eric Church) - Jason Aldean
Little Talks - Of Monsters and Men
Pop That (feat. Rick Ross, Drake and Lil Wayne) - French Montana
Madness - Muse
Numb - Usher
Pound the Alarm - Nicki Minaj
Pontoon - Little Big Town
Give Your Heart a Break - Demi Lovato
Turn On the Lights - Future
I Can Only Imagine (feat. Chris Brown and Lil Wayne) - David Guetta, Chris Brown and Lil Wayne
Sweet Nothing (feat. Florence Welch) - Calvin Harris
We Are Young (feat. Janelle Monáe) - Fun.
Creepin' - Eric Church
Every Storm (Runs Out of Rain) - Gary Allan
Ready or Not - Bridgit Mendler
Wobble - V.I.C.
No Worries (feat. Detail) - Lil Wayne
What Makes You Beautiful - One Direction
Payphone (feat. Wiz Khalifa) - Maroon 5
Somebody That I Used to Know (feat. Kimbra) - Gotye
Thrift Shop (feat. Wanz) - Macklemore and Ryan Lewis
Cowboys and Angels - Dustin Lynch
Beer Money - Kip Moore
Don't You Worry Child (Radio Edit) [feat. John Martin] - Swedish House Mafia
Undermine (Nashville Cast Version) - Charles Esten and Hayden Panettiere
Come Wake Me Up - Rascal Flatts
Moves Like Jagger (Studio Recording from "The Voice" Performance) [feat. Christina Aguilera] - Maroon 5
Truck Yeah - Tim McGraw
Thinkin Bout You - Frank Ocean
If I Didn't Know Better (Nashville Cast Version) - Sam Palladio and Clare Bowen
When She Says Baby - Jason Aldean
Adorn - Miguel
Hello - Karmin
Yeah Yeah - Willy Moon
No Lie (feat. Drake) - 2 Chainz
The One That Got Away - Jake Owen
Sail - AWOLNATION
2 Reasons (feat. T.I.) - Trey Songz
She's So Mean - Matchbox Twenty
Firework - Katy Perry
BURN IT DOWN - Linkin Park
How Country Feels - Randy Houser
Til My Last Day - Justin Moore
If I Didn't Know Better (Nashville Cast Version) [Radio Mix] - Sam Palladio and Clare Bowen
R.I.P. (feat. Tinie Tempah) - Rita Ora
